
Language Region: 0 845 English
Entity	Type
PRESS DIGEST - France	LOCATION
Le Monde	ORGANIZATION
Aug 22	TEMPORAL:DATE
PARIS	LOCATION
1996-08-22	TEMPORAL:DATE
Thursday	TEMPORAL:DATE
Le Monde	ORGANIZATION
Aug 23	TEMPORAL:DATE
Africans	NATIONALITY
Prime Minister	TITLE
Alain Juppe	PERSON
Paris	LOCATION
Wednesday	TEMPORAL:DATE
FLNC	ORGANIZATION
Bally	ORGANIZATION
French	NATIONALITY
French	NATIONALITY
Secretary general	TITLE
PTT	ORGANIZATION
France Telecom	ORGANIZATION
Paris	LOCATION
