
Language Region: 0 672 English
Entity	Type
Tamils	NATIONALITY
U.N.	ORGANIZATION
GENEVA	LOCATION
1996-08-26	TEMPORAL:DATE
Tamils	NATIONALITY
United Nations	ORGANIZATION
European	NATIONALITY
Geneva	LOCATION
Monday	TEMPORAL:DATE
U.N.	ORGANIZATION
Sri Lanka	LOCATION
Nadarajah Muralidaran	PERSON
Swiss	ORGANIZATION
Tamil Tiger	ORGANIZATION
Zurich	LOCATION
April	TEMPORAL:DATE
U.N.	ORGANIZATION
Tamils	NATIONALITY
Liberation Tigers of Tamil Eelam	ORGANIZATION
LTTE	ORGANIZATION
