
Language Region: 0 656 English
Entity	Type
SIX WEEKS	TEMPORAL:TIME
CHICAGO	LOCATION
1996-08-27	TEMPORAL:DATE
Chicago Cubs	ORGANIZATION
Sammy Sosa	PERSON
Monday	TEMPORAL:DATE
six weeks	TEMPORAL:TIME
Tuesday	TEMPORAL:DATE
Sosa	PERSON
National League	ORGANIZATION
August 20th	TEMPORAL:DATE
Mark Hutton	PERSON
Florida Marlins	ORGANIZATION
27-year	TEMPORAL:TIME
Sosa	PERSON
RBI	ORGANIZATION
Sosa	PERSON
Cubs	ORGANIZATION
