
Language Region: 0 1042 English
Entity	Type
Peru	LOCATION
LIMA	LOCATION
Peru	LOCATION
1996-08-21	TEMPORAL:DATE
Peruvian	NATIONALITY
Wednesday	TEMPORAL:DATE
three hours	TEMPORAL:TIME
Tuesday	TEMPORAL:DATE
Maoist	ORGANIZATION
Shining Path	ORGANIZATION
Alomella Robles	PERSON
345 miles	IDENTIFIER:DISTANCE
550 km	IDENTIFIER:DISTANCE
Lima	LOCATION
Wednesday	TEMPORAL:DATE
Shining Path	ORGANIZATION
Abimael Guzman	PERSON
Peru	LOCATION
$ 25 billion	IDENTIFIER:MONEY
