
Language Region: 0 703 English
Entity	Type
Audi	ORGANIZATION
CEO	TITLE
1996-08-29	TEMPORAL:DATE
Audi AG	ORGANIZATION
chairman	TITLE
Herbert Demel	PERSON
Thursday	TEMPORAL:DATE
German	NATIONALITY
Volkswagen AG	ORGANIZATION
Demel	PERSON
Reuters	ORGANIZATION
Audi	ORGANIZATION
Demel	PERSON
April	TEMPORAL:DATE
Demel	PERSON
John Gilardi	PERSON
Frankfurt Newsroom	ORGANIZATION
+49 69 756525	IDENTIFIER:PHONE_NUMBER
