
Language Region: 0 432 English
Entity	Type
ONE-DAY	TEMPORAL:TIME
LONDON	LOCATION
1996-08-25	TEMPORAL:DATE
England	LOCATION
Sunday	TEMPORAL:DATE
one-day	TEMPORAL:TIME
Pakistan	LOCATION
Thursday	TEMPORAL:DATE
Michael Atherton	PERSON
captain	TITLE
Alec Stewart	PERSON
Graham Thorpe	PERSON
Nick Knight	PERSON
Graham Lloyd	PERSON
Matthew Maynard	PERSON
Ronnie Irani	PERSON
Adam Hollioake	PERSON
Robert Croft	PERSON
Darren Gough	PERSON
Peter Martin	PERSON
Dean Headley	PERSON
Alan Mullally	PERSON
