
Language Region: 0 822 English
Entity	Type
Shanghai	LOCATION
SHANGHAI	LOCATION
1996-08-28	TEMPORAL:DATE
Shanghai	LOCATION
Sunday	TEMPORAL:DATE
Writers Association	ORGANIZATION
Wednesday	TEMPORAL:DATE
Dai Houying	PERSON
China	LOCATION
Chinese	NATIONALITY
Anhui	LOCATION
Dai	PERSON
Shanghai	LOCATION
Chinese	NATIONALITY
Hawaii	LOCATION
Chicago	LOCATION
Dai	PERSON
Ren A Ren	PERSON
German	NATIONALITY
English	NATIONALITY
